[
  {
    "grid": [
      "11111111111111111111111111111111111111111111111111",
      "11111111111111111111111111111111111111111111111111",
      "11111111111111111111111111111111111111111111111111",
      "10000000000000000000000000000000011111111111111111",
      "10000000000000000000000000000000011111111111111111",
      "10000000000000000000000000000000011111111111111111",
      "10000000000000000000000000000000011111111111111111",
      "10000000000000000000000000000000011111111111111111",
      "10000000000000000000000000000000011111111111111111",
      "10000000000000000000000000000000011111111111111111",
      "11111111111111111111111111100000011111111111111111",
      "11111111111111111111111111100000011111111111111111",
      "11111111111111111111111111122222211111111111111111",
      "11111111111111111111111111122222211111111111111111",
      "11111111111111111111111111122222211111111111111111",
      "11111111111111111111111111111111111111111111111111",
      "11111111111111111111111111111111111111111111111111",
      "11111111111111111111111111111111111111111111111111",
      "11111111111111111111111111111111111111111111111111",
      "11111111111111111111111111111111111111111111111111"
    ],
    "startx": 3,
    "starty": 6,
    "campfire": [
      {"x": 3, "y": 6},
      {"x": 30, "y": 6}
    ]
  },
  {
    "grid": [
      "11111111111111111111111111111111111111111111111111",
      "10000000011111111000000000000000000000000000000001",
      "10000000011111111000000000000000000000000000000001",
      "10000000011111111000000000000000000000000000000001",
      "10000000011111111000000000000000000000000000000001",
      "10000000011111111000000000000000000000000000000001",
      "10000000011111111000000000000000000000000000000001",
      "10000000011111111000000000000000000000000000000001",
      "10000000011111111000000011111111111111111111000001",
      "10000000011111111000000011111111111111111111000001",
      "10000000011111111000000011000000000000022221000001",
      "10000000011111111000000011000000000000022221000001",
      "10000000000000000000000011000000000000022221000001",
      "10000000000000000000000011000000000000022221000001",
      "10000000000000000000000011000000111111111111000001",
      "10000000000000000000000011000000000000000000000001",
      "10000000000000000000000011000000000000000000000001",
      "10000000000000000000000011000000000000000000000001",
      "10000000000000000000000011000000000000000000000001",
      "11111111111111111111111111111111111111111111111111"
    ],
    "startx": 2,
    "starty": 2,
    "campfire": [
      {"x": 12, "y": 16},
      {"x": 40, "y": 5}
    ]
  },
  {
    "grid": [
      "11111111111111111111111111111111111111111111111111",
      "10000000000010000000000000000000100000000000000001",
      "10000000000010000000000000000000100000000000000001",
      "10000000000010000000000000000000100000000000000001",
      "10000000000010000111111111110000100011111111110001",
      "11111111000010000100000000000000100010000000000001",
      "10000000000010000100000000000000100010000000000001",
      "10000000000010000100000000000000100010000000000001",
      "10000000000010000100011111110000100010000111111111",
      "10000000000010000100011111110000100010000000000001",
      "10000111111110000100000000010000100010000000000001",
      "10000000000000000100000000010001110011111111110001",
      "10000000000000000100000000010000000010000000010001",
      "10000000000000000100011100010000000010000000010001",
      "10000000000000000100011100010000000010011111010001",
      "10000111111111111100011100011111111110010000010001",
      "10000000000000000000011100000000000000010011110001",
      "10000000000000000000011100000000000000010000002221",
      "10000000000000000000011100000000000000010000002221",
      "11111111111111111111111111111111111111111111111111"
    ],
    "startx": 2,
    "starty": 2,
    "campfire": [
      {"x": 4, "y": 15},
      {"x": 32, "y": 13},
      {"x": 47, "y": 2},
      {"x": 24, "y": 11},
      {"x": 42, "y": 15}
    ]
  }
]
