[
  {
    "grid": [
      "11111111111111111111111111111111111111111111111111",
      "10000000000000000000000000000000000000000000000001",
      "10000000000000000000000000000000000000000000000001",
      "10000000000000000000000000000000000000000000000001",
      "10000000000000000000000000000000000000000000000001",
      "10000000000000000000000000000000000000000000000001",
      "10000000000000000000000000000000000000000000000001",
      "10000000000000000000000000000000000000000000000001",
      "10000000000000000000000000000000000000000000000001",
      "10000000000000000000000000000000000000000000000001",
      "10000000000000000000000000000000000000000000000001",
      "10000000000000000000000000000000000000000000000001",
      "10000000000000000000000000000000000000000000000001",
      "10000000000000000000000000000000000000000000000001",
      "10000000000000000000000000000000000000000000000001",
      "10000000000000000000000000000000000000000000000001",
      "10000000000000000000000000000000000000000000000001",
      "10000000000000000000000000000000000000000000000001",
      "10000000000000000000000000000000000000000000000001",
      "11111111111111111111111111111111111111111111111111"
    ],
    "startx": 5,
    "starty": 10,
    "finishx": 48,
    "finishy": 18
  },
  {
    "grid": [
      "11111111111111111111111111111111111111111111111111",
      "10000000000010000000000000000000100000000000000001",
      "10000000000010000000000000000000100000000000000001",
      "10000000000010000000000000000000100000000000000001",
      "10000000000010000111111111110000100011111111110001",
      "11111111000010000100000000000000100010000000000001",
      "10000000000010000100000000000000100010000000000001",
      "10000000000010000100000000000000100010000000000001",
      "10000000000010000100011111110000100010000111111111",
      "10000000000010000100011111110000100010000000000001",
      "10000111111110000100000000010000100010000000000001",
      "10000000000000000100000000010001110011111111110001",
      "10000000000000000100000000010000000010000000010001",
      "10000000000000000100011100010000000010000000010001",
      "10000000000000000100011100010000000010011111010001",
      "10000111111111111100011100011111111110010000010001",
      "10000000000000000000011100000000000000010011110001",
      "10000000000000000000011100000000000000010000000001",
      "10000000000000000000011100000000000000010000000001",
      "11111111111111111111111111111111111111111111111111"
    ],
    "startx": 2,
    "starty": 2,
    "finishx": 48,
    "finishy": 18
  }
]
