[
  "11111111111111111111111111111111111111111111111111",
  "10001000000010000000100000000000000000000000000001",
  "10001000000010000000100000000000000000000000000001",
  "10001000000010000000100000000000000000000000000001",
  "10001000100010001000100000000000000000000000000001",
  "10001000100010001000100000000000000000000000000001",
  "10001000100010001000100000000000000000000000000001",
  "10001000100000001000100000000000000000000111111111",
  "10001000100000001000100000000000000000000100000001",
  "10001000100000001000100000000000000000000100000001",
  "10001000111111111000100000000000010100000100000001",
  "10001000100000000000100000000000110111111100010001",
  "10001000100000000000100000000000100000000000010001",
  "10001000100000000000100000000000100000000000010001",
  "10001000100011111111100000000000100000000000010001",
  "10001000100011111111111111111111111111111111110001",
  "10000000100000000000000000000000000000000000000001",
  "10000000100000000000000000000000000000000000000001",
  "10000000100000000000000000000000000000000000000001",
  "11111111111111111111111111111111111111111111111111"
]
